1111111111111111111111111111111111
1000000000000000000000000000000001
10E00000000000000000000000C0000001
1000000000000000000000000000000001
10000C0000000000000000000000000001
1000000000000000000000000000000001
1000000000000000000000000000000001
1000000000000000000000000000000001
100000000C000000000000000000000001
100000000000000000000CC0C000000001
100000000000000000000000C0CC000001
1000000000000000000000000CCC000001
10CCCCCCCCCCCCCCCC0C00000000000001
1000000000000000000000000000000001
1000000000000000000000000000000001
10000000000000000000000000000C0001
1000000000000000000000000000000001
1000000C00000000000000000000000001
1000000000000000000000000000P00001
1111111111111111111111111111111111