1111111111111111111111111111111111111
1100110000000000000000000111111111111
000001000000C000000000000111111111111
1001101000000000000000001111110000001
11000000P00C0C000C0000001111110000011
1111111000000010000000000111111000001
1000001100001000000000001101111111111
100000000001C111111111111111111111111
1000000000000E00000000000111111110111
1111111111111111111111111111111111111